F 10,20,255
C 116,250,255
WE ./textures/WE.xpm
NO ./textures/NO.xpm

EA ./textures/EA.xpm


111111
100001
100S01
100001
1111111
