C 153,255,255
F 100,100,100
NO ./game_assets/NO.xpm
SO ./game_assets/SO.xpm
EA ./game_assets/EA.xpm
WE ./game_assets/WE.xpm

11111111111  111
10000000001  101
1000000000111101
1000000000000001
1111111111111111