C 153,255,255
F 100,100,100
NO ./game_assets/NO.xpm
SO ./game_assets/SO.xpm
EA ./game_assets/EA.xpm
WE ./game_assets/WE.xpm



1111
10S1
1111