C 153,255,255
F 100,100,100
NO ./game_assets/NO.xpm
SO ./game_assets/SO.xpm
EA ./game_assets/EA.xpm
WE ./game_assets/WE.xpm

BBBBBBBBBBBBBBBBBB
B11111111111BB111B
B10S00000001BB101B
B1000000000111101B
B1000000000000001B
B1111110111111111B
BBBBBBBBBBBBBBBBBB


1111
1001
1011
111

h 4 w 4
malloc(6 x 6)

000000
011B10
010010
010110
011100
000000