C 153,255,254
F 134,87,255
NO ./textures/NO.xpm
SO ./textures/SO.xpm
EA ./textures/EA.xpm
WE ./textures/WE.xpm



        1111111111111111111111111
        1000000000110000000000001
        10100W0001110000000000001
        1001000000000000000000001
111111111011000001110000000000001
100000000011000000010111111111111
11110111111111011100000010001
11110111111111011101010010001
11000000110101011100000000001
10000000000000001100000010001
10000000000000001101010010001
11000001110101011111011110111
11110111 1110101 101111011011
11111111 1111111 111111111111